0000000000000000000000000
0000000000000000000000000
0000000000000000000000000
0000000000000000000000000
0000000000000000000000000
0000000000000000000000000
0000000000000000000000000
0000000000000000000000000
0000000000000000000000000
0000000000000000000000000
0000000000000000000000000
00000000000BB000000000000
MMMMMMMMMMMBBMMMMMMMMMMMM
0000000000000000000000000
0000000000011000000000000
0000000000011000000000000
0000000000011000000000000
0000000000011000000000000
0000000000011000000000000
T33303330001100003330333T
0333033300011000033303330
T22202220001100002220222T
0222022200011000022202220
T01000100001100000100010T
0T111111111111111111111T0
T00000000001100000000000T
0T000000000110000000000T0
T0T00000001GG100000000T0T
0T0T000001GGGG1000000T0T0
T0T00T00001GG1000000T0T0T
0000000000011000000000000
0000000000011000000000000
MMMMMMMMMMM11MMMMMMMMMMMM
0000000000011000000000000
0000000000011000000000000
0000000000011000000000000
T0T0T00000011000000000000
0T0T000000011000000000000
T0T0000000011000000333T0T
0T033300000110000003330T0
T0T3330000011000000222T0T
0T022200000110000002220T0
T0T2220000011000000010T0T
0T0010000001100000001T0T0
T0T0111111111111111110T0T
0T0000000001100000000T0T0
T0T0T00W000110000000T0T0T
000T00000001100000000T0T0
0T000T0000011000000T00T00
0000000000011000000000000
