0000000000000000000000000
0000000000000000000000000
0000000000000000000000000
0000000000000000000000000
0000000000000000000000000
0000000000000000000000000
0000000000000000000000000
0000000000000000000000000
0000000000000000000000000
0000000000000000000000000
0000000000000000000000000
0000000000000000000000000
0000000000000000000000000
0000000000000000000000000
0000000000000000000000000
0000000000000000000000000
0000000000000000000000000
0000000000000000000000000
0000000000000000000000000
0000000000000000000000000
0000000000000000000000000
0000000000000000000000000
0000000000000000000000000
0000000000000000000000000
0000000000000000000000000
0000000000000000000000000
0000000000000000000000000
0000000000000000000000000
0000000000000000000000000
0000000000000000000000000
0000000000000000000000000
0000000000011000000000000
0000000000011000000000000
0000000000011000000000000
0000000000011000000000000
0000000000011000000000000
T0T0T00000011000000000000
0T0T000000011000000000000
T0T0000000011000000333000
0T03330000011000000333000
T0T3330000011000000222000
0T02220000011000000222000
T0T2220000011000000010000
0T00100000011000000010000
T0T0111111111111111110000
0T00000000011000000000000
T0T0T00W00011000000000000
000T000000011000000000000
0T000T0000011000000T00000
0000000000011000000000000
